norsk ord 

vits = joke,
opptatt av = concerned with,
mening = opinion/meaning,
påstand = claim,
på landet = in the countryside,
bør = should,
nøye = thorough it,
å ta ting som de kommer = take thing as it goes,
fast = firm or fix,
du man = you (but not you),
hva som er = what is,
voksen alder = adult age,
punktlig = punctual,
høytider = holidays,
hva som gjør = what does,
å spille en rolle = to play a role,
kjede = chain,
yrkesopplæring = vocational training,
å mestre = to master,
fellesskapet = the community,
lekser = homework,
legge til rette for = to facilitate,
ansvar = responsibilty
flertall = majority,
underholdning = entertainment,
myndighetene = the authorities,
foretrekker = prefer,
forvirrende = confusing,
skifte klær = change clothes,
jeg forventer = i expect,
ettertid = in retrospect,
fremskritt = progress,
bærekraft = sustainability,
står overfor = is facing,
holdninger = attitudes,
kom overens med = got along with,
velferdssystem = welfare system,
friluft = outdoors,
uventet = unexpected,
oppstå = arise,
hvordan vurdere du = how do you evaluate,
å tilpasse deg = to adapt,
å bevare = to preserve,
i en stadig = in a constant,
virkelig stolt = really proud,
tilnærming til = approach to,
klimaendringer = climate change,
uenigheter = disagreements,
en historisk hendelse = a historical event,
jeg la merke til = i noticed,
oppnådde = achieved,
fornybar energi = renewable energy,
forholdet = relationship,
overbevise = convince,
til livslang  = for life,
velvære = well-being,
taklet = coped,
etiske utfordringene = ethical challenges,
matopplevelse = dining experience,
inntrykk = impression,
knyttet = linked,
forstod = understood,
de siste tiårene = in recent decades,
av noe uventet = of something unexpected,
en sterk forbindelse = a strong connection,
levekostnader = living expenses,
et standpunkt = a standpoint,
av fornybar = of renewable,
mangfold = diversity,
eldreomsorg = elderly care,
andres forventninger = other people's expectations,
å bevare urfolkskulturer = to preserve indigenous cultures,
forverre læringsprosessen = worsen the learning process,
erstattes med = replaced with,
undervisningsmetoder = teaching methods,
utdanningsministre = education ministers,
egenskapene en leder = the qualities of a leader,
en øvre aldersgrense = an upper age limit,
i visse yrker = in certain professions,
å bli selvstendig = to become independent,
næringsdrivende fremfor ansatt = entrepreneur rather than employee,
enten du liker det eller ikke = whether you like it or not,
sosial ulikhet = social inequality,
fremme likestilling i = promote gender equality in,
som regjeringen = as the government,
helsevesenet = healthcare,
forebygge psykiske = prevent mental,
i befolkningen = in the population,
til å trene regelmessig = to exercise regularly,
ensomhet folks = loneliness people,
tiltakene = the measures,
for å bekjempe klimaendringer = to combat climate change,
for å nå klimamål = to achieve climate goals,
bærekraftig = sustainable,
plastforurensning = plastic pollution,
det innføres strengere = stricter measures are being introduced,
øke bevisstheten = raise awareness,
for å bli karbonnøytralt = to become carbon neutral,
flyktninger = refugees,
utenrikspolitikk = foreign policy,
økende polarisering i politikken = increasing polarization in politics,
stemmerettsalderen senkes = the voting age is lowered,
et flertallsparti-system = a majority-party system,
skattesystemet = tax system,
strengere = stricter,
av avhengighet = of addiction,
innvirkning = impact,
rettighetene = the rights,
vinning = profit or gain,
rettferdighet = justice,
parforhold = relationship,
mellommenneskelige = interpersonal,
på tvers = across,
å opprettholde = to maintain,
verdenssyn = worldview,
et forbrukersamfunn = a consumer society,
oppfatning = perception,
miljøvern = environmental protection,
bærekraftig = sustainable,
ungdommer = youth,
likestilling or likhet = equality,
fattigdom = poverty,
boligmarked = housing market,
entreprenørskap = entrepreneurship,
mediesituasjon = media situation,
fremme = promote,
kunstnere = artists,
samfunnsansvar = social responsibility,
miljøbevissthet = environmental awareness,
rettferdighet = justice,
arbeidsmarkedspolitikk = labor market policy,
helsevesen = healthcare,
samfunnsengasjement = community involvement,
forståelse = understanding,
kulturell utveksling = cultural exchange,
velferdssystemet = the welfare system,
hatprat = hate speech,
ytringsfrihet = freedom of expression,
dugnadsånden = volunteer spirit,
teoretisk = theoretical,
å bekjempe diskriminering = to combat discrimination,
å bekjempe klimaendringer = to combat climate change,
elbilpolitikken = electric car policy,
et fossilfritt = a fossil-free,
å fly innenlands = to fly domestically,
lidelser = suffering,
kroppspress = body pressure,
behandlingsformer = treatments,
dødshjelp = euthanasia,
beslutningsprosesser = decision-making processes,
overvåkning = monitoring,
personvern = privacy,
få tilgang til = access,
smarttelefoner = smartphones,
skjermbruk = screen usage,
undervisningen = the teaching,
fjernundervisning = distance learning,
å bryte loven = to break the law,
går utover ens egen trygghet = goes beyond one's own safety,
rike mennesker ha plikt = rich people have a duty,
dødsstraff = death penalty,
dyr i forskning = animals in research,
variere = vary,
oppveksten = upbringing,
å ha tydelige mål = to have clear goals,
motgang = hardship,
å utfordre seg selv = to challenge oneself,
innføres = introduced,
borgerlønn = basic salary,
høflig = polite,
skjebne = fate,
en tilfeldighet = a coincidence,
tilfeldigheter = coincidences
forandre = change,
værnes = be protected,
samfunnsendringer = social changes,
arbeidsmarked = labor market,
å beskytte privatlivet = to protect privacy,
avhengighet = addiction,
håndtere = handle,
straff = penalty,
lokalsamfunn = local community,
et kunstverk = a work of art,
tidsalderen = era,
underbygge = substantiate,
synspunkt = point of view,
avgjørende = decisive,
forestill = imagine,
å fremme = to promote,
har utviklet = has developed,
samfunnsstrukturen = social structure,
anta at du blir bedt  = suppose you are asked,
tenk deg at = imagine that,
ambisiøst = ambitiously,
tilsynelatende = apparently,
bærekraftig forbruk = sustainable consumption,
er svært kostbar = is very expensive,
en negativ innvirkning = a negative impact,
vil føre til = will lead to,
medføre = entail,
i hvilken grad = to what extent,
markedsføring = marketing,
et velfungerende demokrati = a well-functioning democracy,
en sterk velferdsstat =  a strong welfare state,
likestillingsarbeidet = equality work,
en globalisert verden = a globalized world,
friluftsliv = outdoor activities,
integrert = integrated,
velferdsstaten = the welfare state,
skattenivået = tax level,
barneoppdragelse = child rearing,
miljøtiltak = environmental measures,
ytterligere = additional,
fotavtrykk = footprint,
utenlandske = foreign,
foreldrepermisjonsordningene = parental leave schemes,
skiller = differ,
utlendinger = foreigners,
langsiktige planer = long-term plans,
fredsmekling = peace mediation,
konfliktløsning = conflict resolution,
klimasamarbeid = climate cooperation,
flyktningkriser = refugee crises,
dagligtale = everyday speech,
prege det norske = characterize the Norwegian,
hensyn = consideration,
tilhørighet = affiliation,
byområder = urban areas,
fraværsgrensen = absence limit,
nabolaget = the neighborhood,
fasiliteter = facilities,
har du bodd = have you lived,
på nåværende adresse = at current address,
matvaner = eating habits,
helsevesenet = healthcare,
kostholdsvaner = dietary habits,
kulturforskjeller = cultural differences,
sammenhenger = contexts,
anledninger = occasions,
foreninger = associations,
kildesortering = source separation,
kollektivtilbudet = public transport,
miljøutfordringer = environmental challenges,
norskkunnskapene = Norwegian language skills,
på lang sikt = in the long term,
til fremover = to the future,
funksjoner = features,
favorittferiemål = favorite travel destination,
innendørs = indoor,
viktig å bevare = important to preserve,
for å redusere avfall i hverdagen = to reduce waste in everyday life,
å beskytte = to protect,
innvandring = immigration,
minneverdig = memorable,
hjemmeundervisning = homeschooling,
gode søvnvaner = good sleep habits,
kampanjer = campaigns,
økoturisme = ecotourism,
du forbinder = you associates,
kosthold = diet,
hva ville du gjort hvis = what would you do if,
jeg mener = i mean,
etter min mening = in my opinion,
for eksempel = for example,
Kan du utdype = can you elaborate,
ferdigheten = the skill,
en ferdighet = a skill,
forurensning = contamination,
fika/kaffepause = coffee,
krangler = arguing,
beundrer = admires,
begivenhet = event,
foretrekke = prefer,
fremmedspråk = foreign language,
begrunn = justify,
overraskelsesfest = surprise party,
forberedelser = preparations,
dagens klimaengasjement blant unge = today's climate engagement among young people,
plastforbruket = plastic consumption,
fritidsaktiviteter = leisure activities, 

















































































































